be irresolute -> seçenekler arasýnda kararsýz kalmak
obstacle -> engel
tükenmek -> drain away
valiant,brave -> cesur, yiðit
creeper -> sarmaþýk
alley -> sokak arasý
blame -> ayýplamak
accuse -> suçlamak
faith -> inanç
strained -> gergin
sincerely -> samimi olarak
flush -> yüzü kýzarmak
identifier -> belirteç
reuse -> yeniden kullanmak
omission -> ihmal
neglect -> ihmal etmek
guilty -> suçlu
clue -> ipucu
hazard -> risk,tehlike
batch -> bir defada alýnan miktar, yýðýn
strain -> gerilmek
audit -> denetim
predecessor -> cet,ata
alias -> sahte isim
associate -> birleþtirmek,iliþkilendirmek
reward -> ödüllendirmek, mükafat
regard -> saymak, hesaba katmak
agent -> temsilci
arbitary -> keyfi
rigid -> sert, sabit
gantry -> rampa
collision -> çarpýþma
regarded -> addedilen
outcomes -> sonuçlar
kite -> uçurtma
crucial -> çok önemli
redundancy -> dolambaçlý yol
reinforcement -> takviye,takviye etmek
intent -> niyet,maksat
scribing -> sivri uçla çizme
proposal -> öneri,teklif
literally -> kelime kelime
thrill -> heyecan , bela
proper -> uygun,münasip
deserve -> hak etmek,layýk olmak
dilution -> seyreltme
portion -> paylaþtýrmak
distorting -> bozucu
best regards -> saygýlarýmla
arbitrarily -> isteðe göre
sufficiently -> yeteri kadar
refer -> iþaret etmek, kastetmek
identical -> ayný
restrict -> sýnýrlamak
intuitive -> sezgisel
tailor -> terzi
sew -> dikmek
gambling -> kumarcý
misery -> sefalet, ýsdýrap
sin -> günah
mitzvah -> sevap
holdout -> reddetme
consultant -> uzman, danýþman
competitive -> rekabetçi
portion -> paylaþtýrmak
leakage -> sýzýntý
resemble -> benzemek
witness -> þahit olmak, tanýk
convict -> mahkum
nebulous -> þüpheli, net olmayan
cram -> ineklemek, çok çalýþmak
veer -> yön deðiþtirmek
concerned -> ilgili, endiþeli
adopt -> evlat edinmek
embarrass -> mahcup etmek, utandýrmak
beat -> data
maltreated -> kötü davranýlmýþ, suistimale uðrayan
sweetheart -> tatlým
cutie -> sevimli kýz, tatlýþ
mofo -> þerefsiz, (slang)
grocery store -> bakkal, toptancý
broad -> engin, geniþ
pernicious -> tehlikeli, kötücül
superficially -> yalapþap, üstünkörü
convincing -> inandýrýcý
myriad -> çok büyük sayý
consequence -> netice ,akýbet
studied -> üzerinde çalýþýlmýþ, düþünülmüþ
voracious -> obur
adversarial - muhalif
beggar -> dilenci
nip -> kýstýrmak
here we go -> iþte baþlýyoruz, haydi bakalým
leak -> sýzdýrmak
supposedly -> sözümona, sözde
adorable -> tapýlasý, þirin
creepy -> ürpertici
underscore ->alt tre
explicitly -> açýk bir þekilde
consequence -> netice, sonuç
instantiate -> kanýt sunmak, örneklerle desteklemek
detach -> kopmak, ayrýlmak
